Budiš se na travi. Sve oko tebe izgleda... kockasto. Drveće, tlo, čak i sunce. Jedna misao ti prolazi glavom: Ovo izgleda kao Minecraft.
Izgubljeni u svijetu blokova
An Interactive Fiction by Nensi Vugrinec
Release 1 / Serial number 260118 / Inform 7 v10.1.2 / D

Forest
Nalaziš se u šumi punoj kockastog drveća. Sve izgleda neprirodno savršeno. Na tlu vidiš crafting table.

You can see some sticks, a torch and a villager here.

>LOOK
Forest
Nalaziš se u šumi punoj kockastog drveća. Sve izgleda neprirodno savršeno. Na tlu vidiš crafting table.

You can see some sticks, a torch and a villager here.

>south
Mrak je pregust. Imaš loš predosjećaj i odlučuješ se vratiti.

>ask villager about this place
Villager kaže: Ovo je svijet blokova. Ovdje se ne preživljava slučajno.

* * *

Budiš se na travi. Sve oko tebe izgleda... kockasto. Drveće, tlo, čak i sunce. Jedna misao ti prolazi glavom: Ovo izgleda kao Minecraft.
Izgubljeni u svijetu blokova
An Interactive Fiction by Nensi Vugrinec
Release 1 / Serial number 260118 / Inform 7 v10.1.2 / D

Forest
Nalaziš se u šumi punoj kockastog drveća. Sve izgleda neprirodno savršeno. Na tlu vidiš crafting table.

You can see some sticks, a torch and a villager here.

>ask villager about portal
Villager promrmlja: Portal je izlaz... ali treba mu snažan izvor energije. Samo oni koji su dokazali da se mogu braniti dobiju ključ.

* * *

Budiš se na travi. Sve oko tebe izgleda... kockasto. Drveće, tlo, čak i sunce. Jedna misao ti prolazi glavom: Ovo izgleda kao Minecraft.
Izgubljeni u svijetu blokova
An Interactive Fiction by Nensi Vugrinec
Release 1 / Serial number 260118 / Inform 7 v10.1.2 / D

Forest
Nalaziš se u šumi punoj kockastog drveća. Sve izgleda neprirodno savršeno. Na tlu vidiš crafting table.

You can see some sticks, a torch and a villager here.

>examine villager
Villager te gleda bez imalo iznenađenja.

Nešto promrmlja sebi u bradu: Kristali… rijetki su danas… i opasni u krivim rukama.

>ask villager about portal
Villager promrmlja: Portal je izlaz... ali treba mu snažan izvor energije. Samo oni koji su dokazali da se mogu braniti dobiju ključ.

>ask villager about crystal
Villager odmahne glavom: Prvo moraš dokazati da se znaš braniti.

>ask villager about this place
Villager kaže: Ovo je svijet blokova. Ovdje se ne preživljava slučajno.

* * *

>examine villager
Villager te gleda bez imalo iznenađenja.

Nešto promrmlja sebi u bradu: Kristali… rijetki su danas… i opasni u krivim rukama.

>ask villager about this place
Villager kaže: Ovo je svijet blokova. Ovdje se ne preživljava slučajno.

>ask villager about crystal
Villager odmahne glavom: Prvo moraš dokazati da se znaš braniti.

>examine crafting table
Klasični crafting table. Ako želiš nešto napraviti, ovo je pravo mjesto.

>south
Mrak je pregust. Imaš loš predosjećaj i odlučuješ se vratiti.

>take torch
Taken.

>examine creeper
You can't see any such thing.

>ask creeper about this place
You can't see any such thing.

>examine villager
Villager te gleda bez imalo iznenađenja.

>ask villager about this place
Villager kaže: Ovo je svijet blokova. Ovdje se ne preživljava slučajno.

>examine crafting table
Klasični crafting table. Ako želiš nešto napraviti, ovo je pravo mjesto.

>ask villager about crystal
Villager odmahne glavom: Prvo moraš dokazati da se znaš braniti.

* * *

>examine crafting table
Klasični crafting table. Ako želiš nešto napraviti, ovo je pravo mjesto.

>south
Cave
 Pećina je i dalje mračna, ali baklja osvjetljava zidove prekrivene rudama. Na zidu primjećuješ stari znak. 

You can see a chest (closed) and a creeper here.

>examine sign
Na znaku piše: "U mraku preživljavaju samo oni koji se mogu braniti. Bez mača, mrak brzo postaje grobnica."

>open chest
You open the chest, revealing Two iron ingots.

>take iron ingots
Taken.

>south
Mine
Duboko si u rudniku. Tuneli su uski i mračni. Imaš loš predosjećaj.

You can see a zombie here.

Čim uđeš u rudnik, primjećuješ Zombija kako se okreće prema tebi i polako krene u tvom smjeru.

Zombie je sve bliže. Moraš brzo reagirati!

>south
You can't go that way.

Zombie te sustigne i brutalno napadne.

Forest
Nalaziš se u šumi punoj kockastog drveća. Sve izgleda neprirodno savršeno. Na tlu vidiš crafting table.

You can see some sticks and a villager here.

Budiš se ponovno na travi. Sve izgleda isto kao prije.

>take torch
Taken.

>south
Cave
 Pećina je i dalje mračna, ali baklja osvjetljava zidove prekrivene rudama. Na zidu primjećuješ stari znak. 

You can see a chest (closed) and a creeper here.

>open chest
You open the chest, revealing Two iron ingots.

* * *

>south
Mine
Duboko si u rudniku. Tuneli su uski i mračni. Imaš loš predosjećaj.

You can see a zombie here.

Čim uđeš u rudnik, primjećuješ Zombija kako se okreće prema tebi i polako krene u tvom smjeru.

Zombie je sve bliže. Moraš brzo reagirati!

>north
Bježiš iz rudnika prije nego te zombie uspije sustići.

Cave
 Pećina je i dalje mračna, ali baklja osvjetljava zidove prekrivene rudama. Na zidu primjećuješ stari znak. 

You can see a chest (empty) and a creeper here.

* * *

>ask villager about this place
Villager kaže: Ovo je svijet blokova. Ovdje se ne preživljava slučajno.

>ask villager about portal
Villager promrmlja: Portal je izlaz... ali treba mu snažan izvor energije. Samo oni koji su dokazali da se mogu braniti dobiju ključ.

>ask villager about zombie
Villager kaže tiho: Zombie se ne boji golih ruku. Bez pravog oružja, borba je izgubljena prije nego počne.

>ask villager about creeper
Villager odmahne glavom: Creepera ne možeš pobijediti. Ako počne šištati, jedina pametna stvar je - maknuti se.

* * *

Budiš se na travi. Sve oko tebe izgleda... kockasto. Drveće, tlo, čak i sunce. Jedna misao ti prolazi glavom: Ovo izgleda kao Minecraft.
Izgubljeni u svijetu blokova
An Interactive Fiction by Nensi Vugrinec
Release 1 / Serial number 260118 / Inform 7 v10.1.2 / D

Forest
Nalaziš se u šumi punoj kockastog drveća. Sve izgleda neprirodno savršeno. Na tlu vidiš crafting table.

You can see some sticks, a torch and a villager here.

>examine villaher
You can't see any such thing.

>ask villager about this place
Villager kaže: Ovo je svijet blokova. Ovdje se ne preživljava slučajno.

>south
Mrak je pregust. Imaš loš predosjećaj i odlučuješ se vratiti.

* * *

>south
Cave
 Pećina je i dalje mračna, ali baklja osvjetljava zidove prekrivene rudama. Na zidu primjećuješ stari znak. 

You can see a chest (closed) and a creeper here.

>examine creeper
Zeleno stvorenje koje ti ne ulijeva povjerenje.

>examine villaher
You can't see any such thing.

>ask villager about this place
You can't see any such thing.

>ask villager about crystal
You can't see any such thing.

>examine crafting table
You can't see any such thing.

>south
Mine
Duboko si u rudniku. Tuneli su uski i mračni. Imaš loš predosjećaj.

You can see a zombie here.

Čim uđeš u rudnik, primjećuješ Zombija kako se okreće prema tebi i polako krene u tvom smjeru.

Zombie je sve bliže. Moraš brzo reagirati!

>north
Bježiš iz rudnika prije nego te zombie uspije sustići.

Cave
 Pećina je i dalje mračna, ali baklja osvjetljava zidove prekrivene rudama. Na zidu primjećuješ stari znak. 

You can see a chest (closed) and a creeper here.

>craft sword
Trebaš crafting table za to.

* * *

Budiš se na travi. Sve oko tebe izgleda... kockasto. Drveće, tlo, čak i sunce. Jedna misao ti prolazi glavom: Ovo izgleda kao Minecraft.
Izgubljeni u svijetu blokova
An Interactive Fiction by Nensi Vugrinec
Release 1 / Serial number 260118 / Inform 7 v10.1.2 / D

Forest
Nalaziš se u šumi punoj kockastog drveća. Sve izgleda neprirodno savršeno. Na tlu vidiš crafting table.

You can see some sticks, a torch and a villager here.

>look
Forest
Nalaziš se u šumi punoj kockastog drveća. Sve izgleda neprirodno savršeno. Na tlu vidiš crafting table.

You can see some sticks, a torch and a villager here.

>examine villager
Villager te gleda bez imalo iznenađenja.

Villager nešto promrmlja sebi u bradu: "Kristali… rijetki su danas… i opasni u krivim rukama."

>ask villager about this place
Villager kaže: "Ovo je svijet blokova. Ovdje se ne preživljava slučajno."

>south
Mrak je pregust. Imaš loš predosjećaj i odlučuješ se vratiti.

* * *

>take torch
Taken.

>south
Cave
Pećina je i dalje mračna, ali baklja osvjetljava zidove prekrivene rudama. Na zidu primjećuješ stari znak.

You can see a chest (closed) and a creeper here.

>look
Cave
Pećina je i dalje mračna, ali baklja osvjetljava zidove prekrivene rudama. Na zidu primjećuješ stari znak.

You can see a chest (closed) and a creeper here.

>examine sign
Na znaku piše: "U mraku preživljavaju samo oni koji se mogu braniti. Bez mača, mrak brzo postaje grobnica."

>examine creeper
Zeleno stvorenje koje ti ne ulijeva povjerenje.

>ask creeper about this place
Creeper počne šištati...
BOOM! Creeper eksplodira.

Forest
Nalaziš se u šumi punoj kockastog drveća. Sve izgleda neprirodno savršeno. Na tlu vidiš crafting table.

You can see some sticks and a villager here.

Budiš se ponovno na travi. Sve izgleda isto kao prije.

* * *

Budiš se na travi. Sve oko tebe izgleda... kockasto. Drveće, tlo, čak i sunce. Jedna misao ti prolazi glavom: Ovo izgleda kao Minecraft.
Izgubljeni u svijetu blokova
An Interactive Fiction by Nensi Vugrinec
Release 1 / Serial number 260118 / Inform 7 v10.1.2 / D

Forest
Nalaziš se u šumi punoj kockastog drveća. Sve izgleda neprirodno savršeno. Na tlu vidiš crafting table.

You can see some sticks, a torch and a villager here.

>south
Mrak je pregust. Imaš loš predosjećaj i odlučuješ se vratiti.

>look
Forest
Nalaziš se u šumi punoj kockastog drveća. Sve izgleda neprirodno savršeno. Na tlu vidiš crafting table.

You can see some sticks, a torch and a villager here.

>examine villager
Villager te gleda bez imalo iznenađenja.

Nešto promrmlja sebi u bradu: Kristali… rijetki su danas… i opasni u krivim rukama.

* * *

>ask creeper about this place
Creeper počne šištati...
BOOM! Creeper eksplodira.

Forest
Nalaziš se u šumi punoj kockastog drveća. Sve izgleda neprirodno savršeno. Na tlu vidiš crafting table.

You can see some sticks and a villager here.

Budiš se ponovno na travi. Sve izgleda isto kao prije.

>south
Mrak je pregust. Imaš loš predosjećaj i odlučuješ se vratiti.

* * *

>south
You can't go that way.

Zombie te sustigne i brutalno napadne.

Forest
Nalaziš se u šumi punoj kockastog drveća. Sve izgleda neprirodno savršeno. Na tlu vidiš crafting table.

You can see some sticks and a villager here.

Budiš se ponovno na travi. Sve izgleda isto kao prije.

>examine villager
Villager te gleda bez imalo iznenađenja.

>take torch
Taken.

* * *

>take iron ingots
Taken.

>north
Forest
Nalaziš se u šumi punoj kockastog drveća. Sve izgleda neprirodno savršeno. Na tlu vidiš crafting table.

You can see some sticks and a villager here.

>craft sword
Nedostaju ti stickovi.

>take sticks
Taken.

>craft sword
Uz pomoć crafting tablea izrađuješ željezni mač.

>ask villager about creeper
Villager odmahne glavom: Creepera ne možeš pobijediti. Ako počne šištati, jedina pametna stvar je maknuti se.

>ask villager about zombie
Villager kaže tiho: Zombie se ne boji golih ruku. Bez pravog oružja, borba je izgubljena prije nego počne.

>south
Cave
 Pećina je i dalje mračna, ali baklja osvjetljava zidove prekrivene rudama. Na zidu primjećuješ stari znak. 

You can see a chest (empty) and a creeper here.

>south
Mine
Duboko si u rudniku. Tuneli su uski i mračni. Imaš loš predosjećaj.

You can see a zombie here.

Čim uđeš u rudnik, primjećuješ Zombija kako se okreće prema tebi i polako krene u tvom smjeru.

Zombie je sve bliže. Moraš brzo reagirati!

>attack zombie
Zamahneš mačem i poraziš Zombija. Rudnik je sada siguran.

>east
Portal Chamber
Prostorija je pravilno oblikovana, kao da nije prirodna. U sredini stoji neaktivan portal frame.

You can see a steve here.

>examine steve
Izgleda poznato. Kao da je ovdje već dugo i čeka da netko dođe.

>ask steve about portal
Steve kaže: Portal treba izvor energije. Ja ga ne mogu dati... ali netko u šumi zna više.

>examine portal frame
Masivni okvir portala. Trenutno je neaktivan.

>west
Vraćaš se natrag iz prostorije s portalom.

>north
Bježiš iz rudnika prije nego te zombie uspije sustići.

Cave
 Pećina je i dalje mračna, ali baklja osvjetljava zidove prekrivene rudama. Na zidu primjećuješ stari znak. 

You can see a chest (empty) and a creeper here.

>north
Forest
Nalaziš se u šumi punoj kockastog drveća. Sve izgleda neprirodno savršeno. Na tlu vidiš crafting table.

You can see a villager here.

>ask villager about portal
Villager promrmlja: Portal je izlaz... ali treba mu snažan izvor energije. Samo oni koji su dokazali da se mogu braniti dobiju ključ.

>ask villager about crystal
Villager ti pruži sjajni kristal. Sada si spremna. Ovo je ključ portala.

>south
Cave
 Pećina je i dalje mračna, ali baklja osvjetljava zidove prekrivene rudama. Na zidu primjećuješ stari znak. 

You can see a chest (empty) and a creeper here.

* * *

>east
Portal Chamber
Prostorija je pravilno oblikovana, kao da nije prirodna. U sredini stoji neaktivan portal frame.

You can see a steve here.

* * *

>examine steve
Izgleda poznato. Kao da je ovdje već dugo i čeka da netko dođe.

>activate portal frame
Portal se zatitra, ali se ne uspijeva aktivirati.

>ask steve about portal
Steve se kratko zamisli: Ponekad portali ne reagiraju odmah. Ako si već pokušala… možda je drugi put ključan.

>activate portal frame
Steve te pogleda i tiho kaže: Sretno.

    *** Portal se aktivira. Svjetlost te obavija. Budiš se u svom krevetu... ali na noćnom ormariću leži mali, kockasti dijamant. ***

Would you like to RESTART, RESTORE a saved game, QUIT or UNDO the last command?

* * *

>open chest
You open the chest, revealing Two iron ingots.

>take iron
Taken.

>north
Forest
Nalaziš se u šumi punoj kockastog drveća. Sve izgleda neprirodno savršeno. Na tlu vidiš crafting table.

You can see some sticks and a villager here.

>take sticks
Taken.

* * *

>craft sword
Uz pomoć crafting tablea izrađuješ željezni mač.

>south
Cave
 Pećina je i dalje mračna, ali baklja osvjetljava zidove prekrivene rudama. Na zidu primjećuješ stari znak. 

You can see a chest (empty) and a creeper here.

* * *

>attack zombie
Zamahneš mačem i poraziš Zombija. Rudnik je sada siguran.

>north
Bježiš iz rudnika prije nego te zombie uspije sustići.

Cave
 Pećina je i dalje mračna, ali baklja osvjetljava zidove prekrivene rudama. Na zidu primjećuješ stari znak. 

You can see a chest (empty) and a creeper here.

* * *

>north
Forest
Nalaziš se u šumi punoj kockastog drveća. Sve izgleda neprirodno savršeno. Na tlu vidiš crafting table.

You can see a villager here.

>ask villager about crystal
Villager ti pruži sjajni kristal. Sada si spreman/na. Ovo je ključ portala.

>south
Cave
 Pećina je i dalje mračna, ali baklja osvjetljava zidove prekrivene rudama. Na zidu primjećuješ stari znak. 

You can see a chest (empty) and a creeper here.

* * *

>east
Portal Chamber
Prostorija je pravilno oblikovana, kao da nije prirodna. U sredini stoji neaktivan portal frame.

You can see a steve here.

>west
Vraćaš se natrag iz prostorije s portalom.

>east
Portal Chamber
Prostorija je pravilno oblikovana, kao da nije prirodna. U sredini stoji neaktivan portal frame.

You can see a steve here.

>activate portal frame
Portal se zatitra, ali se ne uspijeva aktivirati.

>ask steve about portal
Steve se kratko zamisli: Ponekad portali ne reagiraju odmah. Ako si već pokušao/la… možda je drugi put ključan.

>activate portal frame
Steve te pogleda i tiho kaže: Sretno.

    *** Portal se aktivira. Svjetlost te obavija. Budiš se u svom krevetu... ali na noćnom ormariću leži mali, kockasti kristal. ***

Would you like to RESTART, RESTORE a saved game, QUIT or UNDO the last command?

* * *

>north
Bježiš iz rudnika prije nego te zombie uspije sustići.

Cave
 Pećina je i dalje mračna, ali baklja osvjetljava zidove prekrivene rudama. Na zidu primjećuješ stari znak. 

You can see a chest (empty) and a creeper here.

>north
Forest
Nalaziš se u šumi punoj kockastog drveća. Sve izgleda neprirodno savršeno. Na tlu vidiš crafting table.

You can see some sticks and a villager here.

>ask villager about creeper
Villager odmahne glavom: Creepera ne možeš pobijediti. Ako počne šištati, jedina pametna stvar je maknuti se.

* * *

>ask villager about zombie
Villager kaže tiho: Zombie se ne boji golih ruku. Bez pravog oružja, borba je izgubljena prije nego počne.

>craft sword
Nedostaju ti stickovi.

* * *

>examine steve
Izgleda poznato. Kao da je ovdje već dugo i čeka da netko dođe.

>examine portal frame
Masivni okvir portala. Trenutno je neaktivan.

>ask steve about portal
Steve kaže: Portal treba izvor energije. Ja ga ne mogu dati... ali netko u šumi zna više.

>west
Vraćaš se natrag iz prostorije s portalom.

* * *

>ask villager about portal
Villager promrmlja: Portal je izlaz... ali treba mu snažan izvor energije. Samo oni koji su dokazali da se mogu braniti dobiju ključ.

>ask villager about crystal
Villager ti pruži sjajni kristal. Sada si spreman/na. Ovo je ključ portala.

* * *

>look
Mine
Duboko si u rudniku. Tuneli su uski i mračni. Imaš loš predosjećaj.

>east
Portal Chamber
Prostorija je pravilno oblikovana, kao da nije prirodna. U sredini stoji neaktivan portal frame.

You can see a steve here.

* * *

>activate portal frame
Portal se zatitra, ali se ne uspijeva aktivirati.

>ask steve about portal frame
There is no reply.

>ask steve about portal
Steve se kratko zamisli: Ponekad portali ne reagiraju odmah. Ako si već pokušao/la… možda je drugi put ključan.

>activate portal frame
Steve te pogleda i tiho kaže: Sretno.

    *** Portal se aktivira. Svjetlost te obavija. Budiš se u svom krevetu... ali na noćnom ormariću leži mali, kockasti dijamant. ***

Would you like to RESTART, RESTORE a saved game, QUIT or UNDO the last command?

* * *

Budiš se na travi. Sve oko tebe izgleda... kockasto. Drveće, tlo, čak i sunce. Jedna misao ti prolazi glavom: Ovo izgleda kao Minecraft.
Izgubljeni u svijetu blokova
An Interactive Fiction by Nensi Vugrinec
Release 1 / Serial number 260118 / Inform 7 v10.1.2 / D

Forest
Nalaziš se u šumi punoj kockastog drveća. Sve izgleda neprirodno savršeno. Na tlu vidiš crafting table.

You can see some sticks, a torch and a villager here.

>take torch
Taken.

* * *

>craft sword
Nedostaju ti stickovi.

>south
Cave
 Pećina je i dalje mračna, ali baklja osvjetljava zidove prekrivene rudama. Na zidu primjećuješ stari znak. 

You can see a chest (empty) and a creeper here.

>north
Forest
Nalaziš se u šumi punoj kockastog drveća. Sve izgleda neprirodno savršeno. Na tlu vidiš crafting table.

You can see some sticks and a villager here.

* * *

>south
Cave
 Pećina je i dalje mračna, ali baklja osvjetljava zidove prekrivene rudama. Na zidu primjećuješ stari znak. 

You can see a chest (closed) and a creeper here.

>south
Mine
Duboko si u rudniku. Tuneli su uski i mračni. Imaš loš predosjećaj.

You can see a zombie here.

Čim uđeš u rudnik, primjećuješ Zombia kako se okreće prema tebi i polako krene u tvom smjeru.

Zombie je sve bliže. Moraš brzo reagirati!

>examine zombie
Trulo čudovište koje te odmah primijeti.

Zombie te sustigne i brutalno napadne.

Forest
Nalaziš se u šumi punoj kockastog drveća. Sve izgleda neprirodno savršeno. Na tlu vidiš crafting table.

You can see some sticks and a villager here.

Budiš se ponovno na travi. Sve izgleda isto kao prije.

* * *

>take torch
Taken.

>take sticks
Taken.

>south
Cave
 Pećina je i dalje mračna, ali baklja osvjetljava zidove prekrivene rudama. Na zidu primjećuješ stari znak. 

You can see a chest (closed) and a creeper here.

* * *

>take iron
Taken.

>north
Forest
Nalaziš se u šumi punoj kockastog drveća. Sve izgleda neprirodno savršeno. Na tlu vidiš crafting table.

You can see a villager here.

>craft sword
Uz pomoć crafting tablea izrađuješ željezni mač.

>ask villager about portal
Villager promrmlja: "Portal je izlaz... ali treba mu snažan izvor energije. Samo oni koji su dokazali da se mogu braniti dobiju ključ."

>south
Cave
 Pećina je i dalje mračna, ali baklja osvjetljava zidove prekrivene rudama. Na zidu primjećuješ stari znak. 

You can see a chest (empty) and a creeper here.

>south
Mine
Duboko si u rudniku. Tuneli su uski i mračni. Imaš loš predosjećaj.

You can see a zombie here.

Čim uđeš u rudnik, primjećuješ zombija kako se okreće prema tebi i polako krene u tvom smjeru.

Zombie je sve bliže. Moraš brzo reagirati!

>attack zombie
Zamahneš mačem i poraziš zombija. Rudnik je sada siguran.

>east
Portal Chamber
Prostorija je pravilno oblikovana, kao da nije prirodna. U sredini stoji neaktivan portal frame.

You can see a steve here.

>ask steve about portal
Steve kaže: "Portal treba izvor energije. Ja ga ne mogu dati... ali netko u šumi zna više."

>west
Vraćaš se natrag iz prostorije s portalom.

* * *

>north
Forest
Nalaziš se u šumi punoj kockastog drveća. Sve izgleda neprirodno savršeno. Na tlu vidiš crafting table.

You can see a villager here.

>ask villager about crystal
Villager ti pruži sjajni kristal. "Sada si spremna. Ovo je ključ portala."

>south
Cave
 Pećina je i dalje mračna, ali baklja osvjetljava zidove prekrivene rudama. Na zidu primjećuješ stari znak. 

You can see a chest (empty) and a creeper here.

* * *

>east
Portal Chamber
Prostorija je pravilno oblikovana, kao da nije prirodna. U sredini stoji neaktivan portal frame.

You can see a steve here.

>ask steve about portal
Steve klimne glavom. "Vidim da imaš kristal. Sad znaš što treba učiniti."

>acitvate portal frame
That's not a verb I recognise.

>activate portal
(the portal crystal)

>activate portal frame
Portal se zatitra, ali se ne uspijeva aktivirati.

>ask steve about portal
Steve se kratko zamisli: "Ponekad portali ne reagiraju odmah. Ako si već pokušala… možda je drugi put ključan."

>activate portal frame
Steve te pogleda i tiho kaže: "Sretno."

    *** Portal se aktivira. Svjetlost te obavija. Budiš se u svom krevetu... ali na noćnom ormariću leži mali, kockasti dijamant. ***

Would you like to RESTART, RESTORE a saved game, QUIT or UNDO the last command?

* * *

>north
Forest
Nalaziš se u šumi punoj kockastog drveća. Sve izgleda neprirodno savršeno. Na tlu vidiš crafting table.

You can see a villager here.

>ask villager about portal crystal
There is no reply.

>ask villager about crystal
Villager ti pruži sjajni kristal. Sada si spreman/na. Ovo je ključ portala.

* * *

>wrst
That's not a verb I recognise.

>west
You can't go that way.

>south
You can't go that way.

>east
Portal Chamber
Prostorija je pravilno oblikovana, kao da nije prirodna. U sredini stoji neaktivan portal frame.

You can see a steve here.

* * *

>take iron ingots
Taken.

>north
Forest
Nalaziš se u šumi punoj kockastog drveća. Sve izgleda neprirodno savršeno. Na tlu vidiš crafting table.

You can see a villager here.

* * *

>east
Portal Chamber
Prostorija je pravilno oblikovana, kao da nije prirodna. U sredini stoji neaktivan portal frame.

You can see a steve here.

>ask villager about portal
You can't see any such thing.

>ask steve about portal
Steve kaže: "Portal treba izvor energije. Ja ga ne mogu dati... ali netko u šumi zna više."